SO ./assets/walls/music.png
NO ./assets/walls/music.png
EA ./assets/walls/music.png
WE ./assets/walls/music.png

F 33,32,33
C 68,2,115

111111111111111
100000000000001
101111011111101
101000010000101
101011111110101
101010000010101
101010111010101
101010101010101
101010101010101
101000001000101
101111111111101
10000S000000001
111111111111111
